000000000000000000000000000000000000000000000000000000000000000000000000000000000000000000000000000
000000000000000000000000000000000000000000000000000000000000000000000000000000000000000000000000000
000000000000000000000000000000000000000000000000000000000000000000000000000000000000000000000000000
000000000000000000000000000000000000000000000000000000000000000000000000000000000000000000000000000
000000000000000000000000000000000000000000000000000000000000000000000000000000000000000000000000000
000000000000000000000000000000000000000000000000000000000000000000000000000000000000000000000000000
111110011111133333311111111222222222222211111110001111111111333333333333331111111110001111111111111
111110011111111333311111111111111111111111111110001111211111111111111111111111111110001111111111111
111110011111111113333111111111111111111111111110001111111131111111111111111111111110001111111111111
111110011111111111111111111111111111111111111110000021111111111111111111111111111110001111111111111
111113311111111111111111111111111111131111111110001121111011111111111111111111111220001111111111111
111113311111111111111111111111111111111111111130001111111111111111111111111111111330001111111111111
111113311111111111111111111111111111111111111130001111113111101111111111111111100011110000111111111
111110411111111111111111111111111111111111111130001111111111131111111111111111100000000000111111111
111111111111111111111111111111111111111111111110001111111111111111111111111111100000000000111111111
111111111111111111111111111111111111111111111110001111112111111111111111100000000001000000000000000
111111111111111111111111111111111111111111111120001111111111111111111111100000000000000000000000000
111111111111111111111111111111111111111111111120001111111111111111111111100000000000000000300000000
111111111111111111111111111111111111111111111120001111111111111111111112200011112222221110012001001
111111111111111111111111111111111111111111111110001111111111111111111112000000000000000000000222001
111111111111111111111111111111111111111111111110001111111111111111111112000000000000000000000222001
111111111111111111111111111111111111111111111110001111111111111111110000001100000000000000000222001
111111111111111111111111111111111111111111111110001111111111111111110000001100000000011111100222001
111111111111111111111111111111111111111111111110001111111111111111110000001100000000000000000222001
111111111111111111111111111111111111111111111110000000000000000000000001111100000000000000000222001
111111111111111111111111111111111111111111111110000000000000000000000001111100000000000000000222001
111111111111111111111111111111111111111111111110003333333333333333333331111100000000000000000111001
111111111111111111111111111111111111111111111110001111111111111111111111111111111111111111111111001
000000000000000000000000000000000000000000000000001111111111111111111111111111111111111111111111001
111111111111111111111111111111111111111111111110001111111111111111111111111111111133111111111111001
111111111111111111111111111111111111111111111110001000000000000000000000000000000000000000000003001
111111111111111111111111111111111111111111111110001000000000000000000000000000000000000000000003001
111111111111111111111111111111111111111111111110001000010000000020001110000000000001110000000003001
111111111111111111111111111111111111111111111110001000030001000010000000003333000000000000000003001
111111111111111111111111111111111111111111111110001000000000000000000000000111100000000000000003001
111111111111111111111111111111111111111111111110001000333333333333333333333333333333333332220003001
111111111111111111111111111111111111111111111110001000333333333333333333333333333333333331110000001
111111111111111111111111111111111111111111111110001001111111111111111111111111111111111112220000001
111111111111111111111111111111111111111111111110001000000000000000000000000000000000000000000000001
111111111111111111111111111111111111111111111110001000111111111111111111111111111111111111111111221
111111111111111111111111111111111111111111111110001000111111111111111111111111111111111111111111001
111111111111111111111111111111111111111111111110001000111111111111111111111111111111111111111111111
111111111111111111111111111111111111111111111110001000111111111111111111111111111111111111111111111
111111111111111111111111111111111111111111111110001000111111111111111111111111111111111111111111111
111111111111111111111111111111111111111111111110011000111111111111111111111111111111111111111111111
111111111111111111111111111111111111111111111112211000111111111111111111111111111111111111111111111
111111111111111111111111111111111111111111111113311000111111111111111111111111111111111111111111111
111111111111111111111111111111111111111111111112211000111111111111111111111111111111111111111111111
111111111111111111111111111111111111111111111113411111111111111111111111111111111111111111111111111
111111111111111111111111111111111111111111111111111111111111111111111111111111111111111111111111111
111111111111111111111111111111111111111111111110001111111111111111111111111111111111111111111111111
111111111111111111111111111111111111111111111110001111111111111111111111111111111111111111111111111
111111111111111111111111111111111111111111111111111111111111111111111111111111111111111111111111111
111111111111111111111111111111111111111111111110001111111111111111111111111111111111111111111111111
111111111111111111111111111111111111111111111110001111111111111111111111111111141111111111111111111
111111111111111111111111111111111111111111111110001111111111111111111111111111111111111111111111111