000000000000000000000000000000000000000000000000000000000000000000
000000000000000000000000000000000000000000000000000000000000000000
000000000000000000000000000000000000000000000000000000000000000000
000000000000000000000000000000000000000000000000000000000000000000
000000000000000000000000000000000000000000000000000000000000000000
000000000000000000000000000000000000000000000000000000000000000000
000000000000000000000000000000000000000000000000000000000000000000
100000000000000000000000000000000000000000000000011100000000000010
100000000000000000000000000000000000000000000000000010000000000010
100000000000000000000000000000000000000000000000000000000000000010
100000000000000000000000000000000000000000000000000000000000000010
100000000000000000000000000000000000000000000000000000010000000010
100000000000000000000000000000000000000010000000000000000000000010
100000000000000000000000000000000000000000000000000000000030000010
100000000000000000000000000000000000000000000000000000000010000010
100000000000000000000000000000000000000000000000000000000000100010
100000000000000000000000000000000000000000000000000000000000000010
100000000000000000000000000000001000000000000000000000000000000014
100000000000000000000000000000000000000000000000000000000000000110
100000000000000000400000000000000000000000000000000000000000000000
100000000000000000000000000000000000000000000000000000000000010000
100000000000000000000000010000000000000000000000000000000000000000
222222222222222222222222222222222222222222222222222220000000002222
000000000000000000000000000000000000000000000000000000000010000000
000000000000000000000000000000000000000000000000000000000000000000
000000000000000000000000000000000000000000000000000000000000000000
000000000000000000000000000000000000000000000000000000001000000000
000000000000000000000000000000000000000000000000000000000000000000
000000000000000000000000000000000000000000000000000000000000000000
000000000000000000000000000000000000000000000000000000010000000000
111000111113311111000000001000000001100000001133333311111111111110
111000111113311110000000001000000001100000001111111111111111111110
111000111113311111000000001000000001100000001111111111111111111110
111000111113311111000000002000000001100000001111111111111111111110
111000111111111111000000002000111111100000001111111111111111111110
111000111111111111000000002000111111111111111111111111111111111110
111000000000000000000011111111111111111111111111111111111111111110
111000000000000000000011111141111111111111111111111111111111111110
111111111111111111000011111111111111111111111111111111111111111110
111111111111111111000011111111111111111111111111111111111111111110
111111111111111111000011111111111111111111111111111111111111111110
222222222222222222222222222222222222222222222222222222222222222220