100000000000000000000000000000000002000000000001
100000000000000000000000000000000003000000000001
100000000000000000000000000000000002000000000001
100000000000000000000000000000000003000000000001
100000000000000000000000000000000003000000000001
100000000000000000000000000000000003000000000001
100000000000000000000000000000000002000000000001
100000000000000000000000000000000003000000000001
100000000000000000100001000000000002000000000001
100000000000000001133331000000000002000000000001
100000000000000010133331100000000002000000000001
100000000000000100133331010000000003000000000001
100000000000001000111111001000000002000000001001
100000000000010000000000000100000003000000010001
100000000000100000000000000000000003000000100001
100000000001000000000000000000000002000001000001
100000000010001222222222221111100001000010001111
100000000100001000000000001000010000000100000011
100000001000001000000000001000001000001000100011
100000010000001111111111111000000100010000100011
100000100000000000000000000000000011100000100011
100001000000000000000000000000000001000000100011
100010000000000000000000000000000001000000000011
100100400000000000000000000000000001000000000011
111111111000022111111111111111111111100111111111
111111111000000111111111111111111111100111111111
111111111000000111111111111111100000000111111111
111111111000000111111111111111100000000111111111
111111111111000000000001111111100000000011111111
111111111111000000000001111111100011100111111111
111111111111000000000001111111100011100111111111
111111111111111000000000000000000011100111111111
111111111111112000000000000000000011100111111111
111111111111112000000000000000000011100111111111
111111111111112333331111111111111111100111111111
111111111111112333331111111111111111100111111111
111111111111112222221111111111111111100221111111
111111111111111111111111111111111111100221111111
111111111111111111111111111111111111100221111111
111111111111111111111111111111111111111111111111