1111111111111111111111111111111111111111111111111111111111111111111111111111111111111111111111
1111111111111111111111111111111111111111111111111111111111111111111111111111111111111111111111
1111111111111111111111111111111111111111111111111111111111111111111111111111111111111111111111
0000000000000000111111111110000000000000011111111111111111111111111111111111111111111111111111
0000000000000000000000000000000000000000000000111111111111111111111111111111111111111111111111
1111111111111100000000000000000000000000000000000000000000111111111111111111111111111111111111
1111111111111111111111111111222133312222111000000000000000111111111111111111111111111111111111
1111111111111111111111111111221133312222111111111111111100111111111111111111111111111111111111
1111111111111111111111111111111111111111111111111111111100111111111111111111111111111111111111
1111111111111111111111111111111111111111111111111111111100111111111111111111111111111111111111
1111111111111111111111111111111111111111111111111111111100111111111111111111111111111111111111
1111111111111111111111111111111111111111111111111111111100111111111111111111111111111111111111
1100000000000000000000000000000000000000000000000000000000111111111111111111111111111111111111
1100000000000000000000000000000000000000000000000000000000000000000000000000000000000000001111
1111111111111111111111111111111111111111111111111111111100000000000000000000000000000000001111
1111111111111111111111111111111111111111111111111111111133111111111111111111111111111110401111
1111111111111111111111111111111111111111111111111111111133111111111111111111111111111111111111
1111111111111111111111111111111111111111111111111111111133111111111111111111111111111111111111
1111111111111111111111111111111111111111111111111111111111111111111111111111111111111111111111